50
.......o..........o...o...ooo.o..o.o....
.............o..................o.o...o.
...oo....o.....o....o.....oo.o....o.oo..
o....o..o...o......ooooo...o.o...oo....o
o......o......oo............o.o.......oo
....o...o.o..o.........o............oo.o
.o..o.......o.o.......o.oo........o..o.o
..o..oo..oo.oo..o.o..........o..o..o..oo
o.......................o....o..o.o.....
..o...o....o.....o.o...........o...o...o
...o...o....o.o.o..o....o..o..o.........
..o..o.....o..o.o..o....o......o........
..o......oooo..o......................oo
....o........o..o..o...........o.o......
......o.....oo...o............o.o.......
.oo..oo......o...........o....o......o..
......o..o.....ooo.......o...........ooo
......................o...o..o.....o....
........o...o.............o.....oo....o.
.o..oo.....oo....oo...o.................
.........o.o..o.....o..ooo.o.........o..
o....o.o................o.o.o..o.......o
.....oo.........o...o..........o..o....o
...o.............ooo.....o.o.o..........
..o.....o...o.o.........o...o.o.........
.o....o........o...o.....o..o....o......
....o.........o..o...o..o....o.......o..
................................o.ooooo.
o..o.......o.......o......o....o......o.
....o......o..o...oo..o............o....
...o..o..oo.o....ooo....o.o.......o....o
...o............o.o.o.oo..o...o.o..o....
o.................o.....o...........o...
o.o............o.....o....o.o.o.......o.
......o.o..........o.oo.o...o.o.o.......
...........o..o.o.....o.oo..........o...
.....oo.....ooo......oo...o......o.o...o
o...o...oo....o...o.o.......o...........
..o...o....o......o..o......o..o........
..oo.....o...........o........oo........
....oo.o...o....o..o.......oo.......o...
..o...........o..o.o.........oo.........
...o...................o......o.........
....o.o..o....o........o..........o.....
..o.o..o....o.o.......oo......o......o..
...o..........o..o........o...o.....o...
oo...o..o.......o.....o.....o..o..oo..o.
....o.o.o.o..................o..........
..o.......o.....o...o..o....o...o....oo.
o............o...oo..oo..o..o.o.o....o..
